xxxxxxxxxxxxxxx
x         x   x
x xxx xxx x x x
x       x x x x
x x x       x x
x x xxxxxxxxx x
x x         x x
x xxxxx xxxxF x
xCr           x
xxxxxxxxxxxxxxx