XXXXXXXXXXXXXXX
XXX        XXFX
XX   X   X    X
XX XXX    XX XX
X   X      X XX
X  X   X X   XX
XX        X  XX
XXXXXX     X  X
XCR    X X   XX
XXXXXXXXXXXXFXX