XXXXXXXXXXXXXXX
XXX    X   XXFX
XX   X   X    X
XX XXXXXXXXXXXX
X  XX      XXXX
X  X   XXX  XXX
XX    X   X  XX
XXXXXX  X  X  X
XCR    XXX   XX
XXXXXXXXXXXXXXX