XXXXXXXXXXXXXXX
X             X
X     xfx     X
X   xxxxxxx xxX
X             X
X   XXXxxx XXXX
X             x
XXXXXxxxxxxx  X
X CR          X
XXXXXXXXXXXXXXX